11111111111111111111111111111111
1P00C0E000000000000C000000000001
10000000000000000000000000110001
10000000000C00000C00000000110001
10000000000000000000000000110001
10000C10000000000000000000000001
10000000000000000000000000101001
1001100000000000C0000000C0010001
10000100000001000000000000111011
10000010000000000000000000001011
10000000000C00000000000000001011
10000000000000000000000000011001
1000000011100000000C000000000001
1000000000000000000100C000101001
10000000000000100000000000011001
1000000000000000001C000000111011
11111111111111111111111111111111
