111111111111111
10TE1P000000C01
1C00T00000100T1
1000000TT000001
10T00C000011111
1000000T001C0C1
11C000011110001
11111000C000111
10C000T000000C1
111111111111111
