1111111111111111111111111111111111
1E0000T00000000C00000C000000000001
1T100101001000T010100100000TT10101
10100100101010100010010000000101T1
1P0000000C00C000T000000000000000C1
1111111111111111111111111111111111
