1111111111
1E000000C1
1000000001
1000C00001
1001111001
10C1CC1C01
1001111001
10000C0001
1C000000P1
1111111111
