11111
1P001
10C011
100E1
11111
