111111111111111
1C00000000000E1
111111000100111
1000000000C1001
100000000110001
100C00010000001
1P00010110001C1
111111111111111
