11111111111
1C0000000C1
10000P00001
1C000E000C1
11111111111
