111111111111111
10001P000000C01
1C00E0000010001
100000000000001
10000C000011111
10000000001C0C1
11C000011110001
11111000C000111
10C0000000000C1
111111111111111
